11111111
1000P001
100000N1
10C00001
10C00001
10C00011
10C0E001
11111111