1111111111111111111
1000P00000000000001
10P0000000000000001
10C0E00000000000001
1111111111111111111