11111111111111111111111111111
1C010000000100000000001000001
10000000000100001000001000001
1100CCC000010000C100001000001
10000000000000001000000000001
10000000000100000000001000001
100N0001000100000000001000001
1000000000010000000P001000001
10000000000100000000001000001
10000000000100000000001000001
100000P000010000E000001000001
10000000000100000000001000001
10000000000100000000001000001
11111111111111111111111111111