11111111111111111111111111111
1C010000000100000000001000001
101P00000001000010000010E0001
1100CCC000010000C100001000001
10000000000000001000000000001
10000000000100000000001000001
100N0000000100000000001000001
10000000000100000000001000001
10000000000100000000001000001
10000000000100000000001000001
10000000000100000000001000001
10000000000100000000001000001
10000000000100000000001000001
11111111111111111111111111111