111111111111111111111111111111111111111111111111111111111111111111111111111111111111111111
10000100000000000C000000000000000000000000100000100000000C00000C00000000000000000000000011
10000C1000000000000N000000000000000000000010000010000000000000CNC0000000000000000000000011
100001000000000100010000000000000000000000010000010000001010000C00010000000000000000000111
10000C0000000011000000000000C0000000000000000000000000000000000000000000000000000000000001
100000000000000000000000E0000000000000000000000000000000CCC0000000000000000100000000000001
100000000000000000000000P00000000011000000100000100000001C10000000000000000000000000000001
10000C000000000000000000000000000011000000100C00100000001010000000111110000000000000000011
100000000000000100010000000000000000000000010000010000000000000CCCC00N10000000000000000011
10000C0000000011000000000000C0000000000000000000000000000000000000111110000000000000000001
1000000000000000000000000000000000000000000000000000000CCC00000000000000000000000000000011
111111111111111111111111111111111111111111111111111111111111111111111111111111111111111111