111111111
100P00001
10000C011
100E00001
1000P0001
100111001
100100001
100000001
1NNNNNNN1
111111111