111111111111111111
100000000000000001
10000C011110000001
100E00001000000001
1000P0001000011111
100111001100000001
1NNNN0000000000001
111110000000010001
100100001000000001
100000001000000001
1NNN00000000111111
110000011000000011
1NN00000NN00001111
111111111111111111