11111111111111111111111111111
10000000000100000000001000001
100000P00001000000000010E0001
1000000000010000C000001000001
10000000000000000000000000001
10000000000100000000001000001
10000000000100000000001000001
10000000000100000000001000001
11111111111111111111111111111